willful = 일부러의 , 계획적인, 고의의; 제 마음대로의, 고집 센 , 괴팍스러운
weave = (옷감카펫바구니 등을) 짜다[엮다], 짜서[엮어서] 만들다; (꽃나무 조각 등을 꼬아서) 엮다[엮어 만들다]; (이야기 등을) 엮다
cripple = 불구로 만들다; 심각한 손상을 주다, 제대로 기능을 못 하게 만들다; 불구자
flicker = 깜박거리다; 스치다; (약하게 재빨리) 움직[실룩]거리다
syllable = 음절
tyke = (특히 말썽쟁이) 아이; 요크셔(Yorkshire) 사람
short = 성마른
cinder = (나무나 석탄이 타고 남은) 재; 잉걸불
wisp = (머리카락잔디 등과 같이 작고 가느다란 것의) 조각[가닥]; (연기구름의) 줄기
ritual = (특히 종교상의) 의식 절차, (제의적) 의례; (항상 규칙적으로 행하는) 의식과 같은[의례적인] 일; 의식상의, 의식을 위한
wedge = 쐐기; 쐐기 모양의 것; 웨지(공 치는 부분이 쐐기 모양으로 되어 있는 골프채)
crumble = 바스러지다; 바스러뜨리다; (건물이나 땅이) 허물어지다[무너지다]; (힘조직 등이) 흔들리다[무너지다]
sprinkle = 뿌리다; 간간이 섞다[포함시키다]; (비가) 약간 뿌리다[보슬보슬 오다]; 작별, 고별
cadence = (말소리의) 억양; (음악 악곡의) 마침(꼴), 카덴스
vie = (어떤 것을 차지하기 위해) 다투다[경쟁하다]
bicker = (사소한 일로) 다투다
char = 숯이 되다, 까맣게 타다; 숯을 만들다, 까맣게 태우다; (가정의) 청소부로 일하다; 
smear = (기름기가 있거나 부드러운 물질을) 마구 바르다[문지르다]; (기름기 등으로) 더럽히다; 중상[비방]하다
festive = cheerful and exciting; suited to a celebration or holiday; 축제의, 기념일의, 축하하는; 크리스마스 때의
crude = 대충의, 대강의; 대충 만든; 막된, 상스러운
fen = (특히 잉글랜드 동부의) 소택지
disagreeable = 유쾌하지 못한; 무례한, 무뚝뚝한
flawed = 결함[결점/흠]이 있는
flail = 마구 움직이다; (팔다리를) 마구 흔들다; (특히 몽둥이로) 패다, 매타작을 하다; 도리깨
tussle = (특히 무엇을 차지하기 위한) 몸싸움, 드잡이; (특히 무엇을 차지하기 위해) 몸싸움을 벌이다, 드잡이를 하다
giggle = 피식 웃다, 킥킥[키득/낄낄]거리다(재미난처함초조감에서 웃는 소리); 피식 웃음, 킥킥[키득/낄낄]거림; 장난
shriek = (흥분공포감고통 등으로 날카롭게) 소리[비명]를 지르다; (날카롭게) 악을 쓰며 말하다, 꽥 소리를 지르다; (흥분공포감고통 등으로 날카롭게 지르는) 비명[악]
toddle = (어린 아이가) 걸음마타다[아장아장 걷다]; 걷다, 가다
scamper = 날쌔게 움직이다
limp = 기운[활기]이 없는, 축 처진[늘어진]; 흐물흐물한, 흐느적거리는; 다리를 절다[절뚝거리다]
pine = 솔, 소나무(= ~ tree); 그 재목
smudge = (더러운) 자국, 얼룩; (특히 잉크페인트가 지저분하게) 번지게 하다[번지다]; (더러운) 자국[얼룩]을 남기다
snuggle = (특히 어떤 사람에게) 바싹 파고들다[달라붙다]; (따뜻하고 안락한 곳에) 파묻다[들이밀다]
topple = 넘어지다; 넘어뜨리다; 실각시키다
entwine = 꼬다, 휘감다; 뒤엉키다, 얽히다
near = (시간거리상으로) 가까워지다[다가오다]
weed = 잡초; 수초, 물풀; 담배
pleasantry = 사교적인 인사[말]
curt = 퉁명스러운
deter = 단념시키다, 그만두게 하다
overhear = (남의 대화 등을) 우연히 듣다
forage = 먹이를 찾다; ~을 찾다; (소말의) 사료
fowl = 가금; 새
pen = 펜; (가축의) 우리; 
refuse = 쓰레기
whip = 채찍; (정당의) 원내 총무; (특정 쟁점에 대해 당원들에게 보내는) 표결 안내문[지시문]
timber = (목재용) 수목[산림]; 목재, 재목; 대들보, 가로장; (선박의) 늑재
sapling = 묘목, 어린나무
squint = 눈을 가늘게 뜨고[찡그리고] 보다(밝은 빛을 피하거나 무엇을 더 잘 보려고 취하는 동작을 나타냄); 사시이다; (사람이) 사시[사팔뜨기]이다
cup = 컵, 잔; 한 잔 (분량); (미국에서 요리 재료를 재는 단위로서의) 컵
whine = 징징[칭얼]거리다, 우는 소리를 하다; 낑낑[끙끙]거리다; 끼익끽 하는 소리를 내다
taunt = 놀리다, 비웃다, 조롱하다; 놀림, 비웃음, 조롱
shrill = 새된, 날카로운; (요구 등이) 소리 높이 외치는[날카로운](하지만 흔히 이치에 안 맞는); 날카로운[새된] 소리를 내다
edifice = (크고 인상적인) 건물; 조직, 체계
ripple = 잔물결, 파문; 잔물결 모양의 것; 파문처럼 번져 가는 소리
pane = (한 장의) 판유리
splendid = 정말 좋은[멋진], 훌륭한; 아주 인상적인[아름다운]; [감탄사] 아주 좋아
cottage = (특히 시골에 있는) 작은 집
barter = 물물교환하다, 물건을 교환하다; 
menace = 위협적인[위험한] 존재; (어조분위기 등으로 느껴지는) 위협[협박]; 성가신[골치 아픈] 존재
glare = 노려[쏘아]보다; (불쾌하게) 환하다[눈부시다]; (불쾌하게) 환한 빛[눈부심]
assent = 찬성, 승인; 찬성하다
frantical = 정신 나간
den = (야생 동물이 사는) 굴; (특히 부정한 행위를 하기 위한) 소굴; 편안히 쉴 수 있는 방, 은신처
malevolence = 악의, 나쁜 마음, 적의, 증오(hatred)
remnant = 남은 부분, 나머지; 자투리(천)
thong = 가죽 끈(무엇을 묶거나 채찍으로 쓰는 것); 끈 팬티(뒷부분이 아주 가늘게 끈처럼 되어 있는 남녀 팬티); 
tentative = 잠정적인; 머뭇거리는, 자신 없는
encrust = [타동사, 자동사] 외피(外皮)로 덮다[를 형성하다]; 아로새기다
saunter = 한가로이[느긋하게] 걷다; 
contemptuous = 경멸하는, 업신여기는
clump = ; 수풀, 나무숲; (관목의) 덤불(thicket); 
grit = 모래, 아주 작은 돌; 투지, 기개; 빙판에 모래[소금 등]를 뿌리다
disrupt = 방해하다, 지장을 주다
impassive = 무표정한, 아무런 감정이 없는
sway = (전후좌우로 천천히) 흔들리다[흔들다]; (마음을) 흔들다[동요시키다]; (전후좌우로) 흔들림[진동]
ooze = (걸쭉한 액체가[를] 천천히) 흐르다[흘리다]; (특징자질 등을) 줄줄 흘리다[내뿜다/발산하다]; (호수강바닥의) 부드러운 진흙, 개흙
illustrious = 저명한; 걸출한
humility = 겸손
yearn = 갈망하다, 동경하다
twinge = 찌릿한 통증; (불쾌하게) 찌르르한 느낌
reverent = 숭배하는
torch = 손전등; ; 횃불
bow = ; (인사복종예배 등으로) 머리를 숙이다, 허리를 굽히다, 절하다, <남자가> 모자를 벗고 인사하다 ((to, before)); 굴종하다(yield), 굴복하다 ((to))
chamber = (공공건물의) 회의실; (단원제가 아닌 의회의) -원(院); (특정 목적용) -실(室)
spill = 흐르다, 쏟아지다; 흘리다, 쏟다; 쏟아져 나오다; 유출; 흘린[쏟은] 액체, 유출물
steady = (발달전개 등이) 꾸준한; 변함[변동]없는, 고정적인, 한결같은; 흔들림 없는, 안정된
interweave = (실털실 등을) 섞어 짜다[넣다]
braid = (실을 꼬아서 만든) 장식용 수술; ; 
thump = (특히 주먹으로 세게) 치다[두드리다]; 쿵[탁] 하고 떨어지다[치다]; 쿵[탁] 하고 놓다[떨어뜨리다]; 쿵쿵[쿵쾅]거리다
sconce = (벽기둥 등에서 쑥 내민) 돌출 촛대; (촛대의) 양초 꽂이
sputter = (엔진불길 등이) 펑펑 하는[털털거리는] 소리를 내다; (분노충격으로) 식식거리며[더듬거리며] 말하다
magnificent = 참으로 아름다운[감명 깊은/훌륭한]
nibble = (특히 음식을) 조금씩[야금야금] 먹다; (제의생각 등에) 약간 관심을 보이다; (조금 베어 문) 한 입[소량]
ravenous = 배가 고파 죽을 지경인; 엄청난
vindictive = 앙심을 품은, 보복을 하려는
crusty = 딱딱한 껍질이 있는; 신경질적인, 화를 잘 내는; (서구 사회에서 관습적인 삶을 거부하는) 떠돌이; 냉랭한 얼굴을 한
throb = 욱신거리다, 지끈거리다; (소리가 규칙적으로 강하게) 고동치다, 울리다; 진동; 욱신[지끈]거림
accusation = 혐의 (제기), 비난; 고발, 기소
refute = 논박[반박]하다; 부인하다
sear = (강한 불에 겉 부분을) 그슬다[재빨리 굽다]; (강한 통증 등이 불길처럼) 후끈 치밀다, 화끈거리게 하다
stakes = 리스크가 크다, 위험성이 높다
contempt = 경멸, 멸시; (법규위험 등을) 개의하지 않음, 무시; 
muscular = 근육의; 근육질의, 근육이 발달한
sinewy = (늘씬한) 근육질의
bracelet = 팔찌
single = 선발하다, 선정하다, 뽑아내다.
ornament = (방정원 등의) 장식품; 장신구; 장식
clasp = (꽉) 움켜쥐다[움켜잡다]; (꽉) 껴안다; (걸쇠를 걸어) 잠그다
relinquish = (특히 마지못해 소유권 등을) 포기하다[내주다]
unbidden = 요청[초대]받지 않은, 예상 밖의
at = 성패가 달려 있는, 위태로운
sullen = 뚱한, 시무룩한; 음침한, 침울한
wrest = 비틀다 ((away)); 비틀어 떼다, 잡아떼다 ((out of, from)); <법사실 등을> 왜곡하다 ((out of, from)); <의미를> 억지로 맞추다; <정보생계동의 등을> 캐[짜]내다(wring), 억지로 얻어내다(extract), 노력하여 얻다 ((out of, from))
abruptly = 갑자기(suddenly), 불쑥, 뜻밖에; 퉁명스럽게, 무뚝뚝하게
fade = (색깔이) 바래다[희미해지다]; 바래게[희미해지게] 만들다; 서서히 사라지다, 점점 희미해지다; (운동선수팀배우 등의 실력이) 시들해지다
steadfast = (태도목표가) 변함없는
blend = 섞다, 혼합하다; 섞이다; (보기 좋게) 조합하다[조합되다]
coax = 구슬리다, 달래다
shove = (거칠게) 밀치다[떠밀다]; 아무렇게나 놓다[넣다]; 힘껏 떠밂[밀침]
radiant = (행복감건강 등으로) 빛나는[환한]; (따스하고 밝게) 빛나는; 복사(輻射)의
talisman = (행운을 가져다준다고 여겨지는) 부적(符籍)
hue = 빛깔, 색조; (신념 등의) 색깔[유형]
fray = (천이[을]) 해어지다[해어지게 하다]; 신경들이 날카로워지다[날카로워지게 만들다]; (특히 자신의 능력을 시험하는 듯한) 싸움[경쟁]
fabulous = 기막히게 좋은[멋진]; 엄청난, 굉장한; 우화에 나오는
robe = (신분의 상징으로 또는 특별한 의식 때 입는) 예복[가운], 대례복, 법복; ; 가운[예복]을 입히다
drab = 생기 없는, 칙칙한; 재미없는
oleander = 협죽도
nonchalantly = 태연하게, 무관심하게, 냉담하게.
feign = (감정질병 등을) 가장하다[~인 척하다]
scavenger = (먹을 것 등을 찾아) 쓰레기 더미를 뒤지는 사람[동물]; 죽은 동물을 먹는 동물[조류]
scrap = (특히 종이옷감 등의) 조각; 조금; (식사 때 먹고) 남은 음식
clatter = 달가닥[털커덕/쨍그랑]하는 소리를 내다; 달그락[털커덕]거리며 가다[움직이다]; 
smirk = 히죽히죽[능글맞게] 웃다; 
yank = 홱 잡아당기다; 
morsel = (특히 음식의) 작은 양[조각]
stub = (쓰다 남은 물건의) 토막, (담배) 꽁초; 몽당연필; (표수표 등에서 한 쪽을 떼어 주고) 남은 부분; (~에) 발가락이 차이다
churn = (물흙탕물 등이[을]) 마구 휘돌다[휘젓다]; (걱정역겨움 등으로) (속이[을]) 뒤틀리다[뒤틀리게 하다]; (마음속에서 분노혼란스러움 등이) 부글거리다[들끓다]
scabbed = 딱지가 있는, 딱지투성이의; 옴이 옮은; 하잘것없는
filch = 좀도둑질을 하다
haughty = 거만한, 오만한
homely = (자기 집처럼) 아늑한[편안한]; 담백한; 가정적인, 따뜻한
mongrel = 잡종견
splint = 부목을 대다
crooked = 비뚤어진, 구부러진; 부정직한; 짜증나는
shrubbery = 관목숲
scavenge = (먹을 것 등을 찾아) 쓰레기 더미를 뒤지다; (직접 사냥한 것이 아닌) 죽은 고기를 먹다
throng = 인파, 군중; (떼를 지어) 모여들다[모여 있다]
nauseate = 욕지기가 나게[메스껍게] 하다; 역겹게 하다
excrement = 대변, 배설물
butcher = 정육점 주인; 도살업자; 정육점; 잔인한 살인자
stalk = <사냥감사람 등에> 몰래 접근하다; 가만히 뒤를 밟다; <이성에게> 집요하게 추근대다; <병재해 등이> <어떤 지방에> 만연하다, 퍼지다; 젠체하며 걷다, 으스대며 걷다, 활보하다
hut = (간단하게 집이나 쉼터로 지은) 오두막[막사]
twitch = 씰룩거리다, 경련하다; 홱 잡아채다[잡아당기다]; 홱 당겨지다; 씰룩거림, 경련
flea = 벼룩
furrow = (쟁기질로 생긴) 고랑[골]; (얼굴의) 깊은 주름; (밭에) 고랑을 만들다
brow = 이마; ; (언덕) 꼭대기, 등성이
wee = (크기가) 아주 작은; (양이) 적은, 조금[약간]의; 쉬(오줌 누기)
squirm = (초조하거나 불편하거나 하여 몸을) 꿈틀[꼼지락]대다; 몹시 당혹해[창피해] 하다
overseer = (작업) 감독(자); (시스템) 감독관[감독 기관]
haphazard = 무계획적인, 되는 대로의
unkempt = 헝클어진, 단정하지 못한
grimy = 때 묻은, 더러운
oblong = 직사각형의; 길쭉한; 
lumpy = 덩어리[응어리]가 많은, 혹투성이의
rueful = 후회하는, 유감스러워 하는
iridescent = 보는 각도에 따라 색깔이 변하는, 무지갯빛의
waddle = (오리처럼) 뒤뚱뒤뚱 걷다; 
beetle = 딱정벌레; (소형) 폭스바겐 (자동차); 휑하니 가다
wanly = 파리하게, 가냘프게.
hubby = 남편
treadle = 발판(특히 과거 발로 밟아 기계를 작동시키던 장치)
flutter = (빠르고 가볍게) 흔들(리)다[펄럭이다/떨다]; (새곤충이 날개를) 파닥이다; 훨훨 날아가다
inert = 기력이 없는; 비활성[불활성]의
blossom = (특히 유실수나 관목의) 꽃; 꽃이 피다, 꽃을 피우다; (얼굴형편이) 피다[좋아지다]
cherish = 소중히 여기다, 아끼다; (마음속에) 간직하다
studded = 장식용 금속 단추를 붙인; ~이 많은
be = 해를 입지 않다
shawl = 숄
glaze = (눈이) 게슴츠레해지다[따분/피곤해 하는 표정이 되다]; 유리를 끼우다; 유리창을 달다; 광택제를 바르다, 윤기가 나게 하다
hearty = (마음이) 따뜻한, 다정한; 원기 왕성한, 쾌활한; 푸짐한; 왕성한
tuber = 덩이줄기; 덩이뿌리
chunky = 두툼한; (몸이) 땅딸막한; 덩어리가 든
fester = 곪다; 곪아터지다, 훨씬 심해지다
impetuous = 성급한, 충동적인
by = 간발의 차이로, 간신히, 구사일생으로
alight = 불붙은, 불타는; (기쁨흥분으로) 빛나는; (~에 날아가) 앉다
jauntily = 명랑하게; 멋을 부려, 멋지게.
captive = 사로잡힌, 억류된; 달리 어쩔 도리가 없는, 그 자리를 뜰 수가 없는; 포로
dismay = (충격을 받은 뒤의) 실망, 경악; 경악하게 만들다, 크게 실망시키다
consign = (무엇을 없애기 위해 어디에) 놓다[두다]; (좋지 않은 상황에) 처하게 만들다; ~에게 ~을 보내다
utensil = (가정에서 사용하는) 기구[도구]
pounce = (공격하거나 잡으려고 확) 덮치다[덤비다]
rodent = 설치류(쥐토끼처럼 앞니가 날카로운 동물)
baggy = 헐렁한
voluminous = 아주 큰; 천이 많이 든; 아주 길고 상세한, 방대한; 아주 큰
wad = (종이돈 등의) 뭉치; (무엇을 막거나 하는 데 쓰이는 부드러운 것의) 뭉치[덩이]; (단단한 덩이가 되게) 뭉치다, 뭉치로 만들다
scrawny = 뼈만 앙상한, 거죽만 남은
sparse = (흔히 넓은 지역에 분포된 정도가) 드문, (밀도가) 희박한
adorn = 꾸미다, 장식하다
intact = (하나도 손상되지 않고) 온전한, 전혀 다치지 않은
deft = 날랜, 재빠른; 능숙한, 능란한
lavish = 풍성한; 호화로운; 아주 후한
hollow = (속이) 빈; 쑥 들어간, 움푹 꺼진; 허허로운
disconcerted = 당혹한, 당황한
strew = 흩다, 흩뿌리다; 흩어지다, 흩뿌려져 있다
reddish = 발그레한, 불그스름한
sanitary = 위생의; 위생적인, 깨끗한
rim = (둥근 물건의) 가장자리[테두리/테]; (바퀴의) 테; 테[가장자리]가 ~한
hoist = (흔히 밧줄이나 장비를 이용하여) 들어[끌어]올리다; (화물장애인을 들어올리기 위한) 승강 장치
gleam = 어슴푸레[희미하게] 빛나다; (아주 깨끗하게) 환하다[반짝이다]; (눈빛이 어떤 감정을 보이며) 반짝거리다
woeful = 통탄할, 한심한; 몹시 슬픈, 비통한
piss = 오줌을 누다[싸다]; ; 오줌 싸기
chuckle = 빙그레[싱긋] 웃다; 
jerk = 홱 움직이다(갑자기 날카롭게 움직이거나 무엇을 움직이게 하는 동작을 나타냄); (갑자기 날카롭게) 홱 움직임; 얼간이
smolder = 그을려서 검게 하다; ; 그을다, 연기 피우다, 연기만 피운채 타 버리다 ((out))
coarse = 거친; (알갱이올 등이) 굵은; 음탕한
gnaw = 쏠다, 갉아먹다, 물어뜯다
lap = <개고양이 등이> 핥다(lick), 핥아 먹다, 게걸스럽게 먹다; <술 등을> 꿀꺽꿀꺽 마시다 ((up)); <파도 등이> <물가를> 씻다, 찰싹거리다; <겉치레말 등을> 기꺼이 듣다, 열심히 듣다 ((up))
cackle = 꼬꼬댁 울다; (불쾌하게) 낄낄 웃다[키득거리다]; 꼬꼬댁
dormant = 휴면기의, 활동[성장]을 중단한
bedstraw = [U] 침대의 속짚; [식물] 갈퀴덩굴속(屬)의 풀
expanse = 넓게 트인 지역
strand = (실전선머리카락 등의) 가닥[올/줄]; (생각계획이야기 등의) 가닥[부분]; (바다호수강의) 물가
stump = (나무의) 그루터기; (주요 부분이 잘리거나 부러지거나 닳고 난 뒤에) 남은 부분; 잘린 팔[다리](팔다리의 절단되고 남은 부분)
stubby = 뭉툭한, 짤막한; 뭉툭한 맥주병(보통 0.375리터들이); (남성용) 반바지
gnarl = (나무) 마디, 옹이, 혹; ; 비틀다(twist)
rust = 녹; (식물의) 녹병[곰팡이병]; 녹슬다, 부식하다; 녹이 슬게 하다, 부식시키다
yarn = (직물편물용) 실, 방적사; (특히 과장되거나 지어낸) 긴 이야기
lush = 무성한, 우거진; 멋진, 비싸 보이는; 
crone = (못생긴) 노파
temperament = 기질; 신경질적임, 괴팍함
fetch = (어디를 가서) 가지고[데리고/불러] 오다; (특정 가격에) 팔리다
exquisite = 매우 아름다운, 정교한; 강렬한, 격렬한; 예리한, 예민한
airy = 바람이 잘 통하는; 대수롭지 않은 듯한; 공허한; 비현실적인
smug = 의기양양한, 우쭐해 하는
avert = 방지하다, 피하다; (~에서) 눈[얼굴]을 돌리다[외면하다]
sling = (되는 대로아무렇게나 휙) 던지다[내던지다]; (느슨하게) 매다[걸다/달다]; (사람을 억지로) 밀어 넣다[내쫓다]
vibrant = 활기찬, 생기가 넘치는; 강렬한, 선명한; 힘찬
trample = 짓밟다, 밟아 뭉개다; (남의 감정권리를) 짓밟다
wreckage = (사고 자동차비행기 등의) 잔해
splinter = (나무금속유리 등의) 조각[가시], 지저깨비; 쪼개지다, 깨지다; 쪼개다, 깨다; 분열[분리]되다, 갈라지다
jagged = 삐죽삐죽한, 들쭉날쭉한
rubble = (허물어진 건물의) 돌무더기[잔해]
clangor = [a ~] 뗑그렁뗑그렁, 뗑뗑, 짤랑짤랑 ((금속성의 연속음)); 뗑그렁뗑그렁 울리다
cluck = (닭이) 꼬꼬댁거리다; 혀를 쯧쯧 차다; 꼬꼬댁(닭이 내는 소리)
skein = (실털실의) 타래
rhyme = 운(음조가 비슷한 글자); 운문; 압운, (특히) 각운
chant = (연이어 외치는) 구호; (단순하고 반복적인 곡조의) 성가; 구호[성가]를 (거듭) 외치다[부르다], 연호하다
overgrow = ; <잡초 등이> 무성하게 나다[자라다], 자라서 뒤덮다; 지나치게 자라다; 
woad = 대청(고대인들이 몸과 얼굴에 칠하는 데 쓰던 청색 물감)
hush = 쉿, 조용히 해[울지 마]; ~을 조용히 시키다[입을 다물게/그만 울게 하다]; 침묵, 고요(특히 한참 시끄럽던 뒤에 또는 무슨 일인가가 일어나기를 기다리는 가운데 존재하는 것)
jostle = (많은 사람들 사이에서) 거칠게 밀치다[떠밀다]
raucous = 요란하고 거친, 시끌벅적한
windowsill = 창턱
shaft = (보통 건물지하의) 수직 통로, 수갱; (망치골프채 등의 기다란) 손잡이[자루]; 화살대; (기계의) 축[샤프트]
tire = 피로[피곤]해지다, 지치다; 피로하게[피곤하게/지치게] 만들다; 
volition = 자유 의지
painstaking = 공들인
portray = (그림글로) 그리다[묘사하다]; (특히 완벽하거나 정확하지 못하게) 나타내다[보여주다]; (영화연극에서 특정한 역할을) 연기하다
snip = (가위로 싹둑) 자르다; (가위로 싹둑) 자르기; 싹둑 (자르는 소리); 금속 절단용 가위
delicate = 연약한, 여린, 다치기[부서지기] 쉬운; 허약한; 섬세한, 우아한
taut = (밧줄 따위가) 팽팽한; (팽팽하게) 긴장된; 팽팽한
infinitesimal = 극미한, 극소의
weaponry = (특정 종류특정 국가나 집단 소유의 모든) 무기[무기류]
tan = (피부가 갈색으로) 햇볕에 타다[그을리다]; 햇볕에 태우다; (가죽을) 무두질하다; 황갈색
graze = 풀을 뜯다; (소양 등을) 방목하다[놓아먹이다]; (피부를) 까지게[긁히게] 하다
hulk = (특히 폐선의) 선체; (특히 제대로 움직이지를 못하는) 거대한 사람; (특히 불안감을 주는) 거대한 것
pale = 창백한, 핼쑥한; (색깔이) 엷은[옅은/연한]; 약한, 흐릿한
immense = 엄청난, 어마어마한
culminate = (~으로) 끝이 나다[막을 내리다]
vastness = 광대(함), 광대한 넓이
pine = 소나무, 솔; 소나무 재목; (사람이 죽거나 떠난 후) 몹시 슬퍼하다[비통해 하다]
raggedy = 누더기의, 다 찢어진; 털이 북슬북슬한; 초라해 보이는; 낡은
grimace = 얼굴을 찡그리다; 찡그린 표정
warily = 조심하여, 방심하지 않고
brisk = 빠른; 바쁜; 딱딱한, 사무적인; (차갑지만) 상쾌한
subdue = 진압하다; (감정을) 가라앉히다[억누르다]
mop = 대걸레, 자루걸레; (짧은 자루가 달린) 설거지용 수세미; (흔히 부스스하고 숱 많은) 머리 뭉치
wail = (슬픔통증 때문에) 울부짖다, 통곡하다, 흐느끼다; (큰소리로) 투덜거리다[불평하다]; (길고 높은) 소리를 내다[울리다]
wiggle = (좌우상하로 짧게) 씰룩씰룩[꼼지락꼼지락/꿈틀꿈틀] 움직이다; (좌우상하로 짧게) 씰룩씰룩[꼼지락꼼지락/꿈틀꿈틀] 움직이기
plaster = (물기가 있거나 끈적한 것을) 바르다
wrinkle = (얼굴에) 주름을 잡다, 찡그리다; 주름이 지다[생기다]
exasperate = 몹시 화나게[짜증나게] 하다
prance = (과장되게뽐내며) 활보하다; 껑충거리며 다니다
brutish = 야수 같은
spot = 발견하다, 찾다, 알아채다(특히 갑자기 또는 쉽지 않은 상황에서 그렇게 함을 나타냄)
prod = (손가락이나 뾰족한 것으로) 쿡 찌르다; 재촉[촉구]하다; (손가락이나 뾰족한 것으로) 쿡 찌르기
swagger = 으스대며[뻐기며] 걷다[활보하다]; 으스대며[뻐기며] 걷기[활보하기]
boast = 뽐내다, 자랑하다; 자랑할 만한 ~을 갖고 있다, 자랑하다; 뽐냄, 자랑
flaunt = 과시하다; 관능미를 과시하다
mutter = (특히 기분이 나빠서) 중얼거리다; 투덜거리다, (작은 소리로) 불평하다; 중얼거림
smooth = 매끈하게 하다, 반듯하게 펴다[매만지다]
cleanse = (피부상처를) 세척하다; ~의 죄책감[죄]을 씻어 주다
stitchery = 꿰매기, 뜨개질, 바느질(needlework); 꿰매기[뜨개질] 장식
shudder = (공포추위 등으로) 몸을 떨다, 몸서리치다, 전율하다; 마구 흔들리다; (공포추위 등으로) 몸이 떨림, 전율, 몸서리
fang = (뱀개 등의) 송곳니
hare = 토끼; 재빨리 뛰어가다[가다]
bravado = 허세
disdainfully = 경멸하여
stalk = (공격 대상에게) 몰래 접근하다; 쫓아다니며 괴롭히다, 스토킹하다
ominous = 불길한
rafter = 서까래
oppressive = 억압[탄압]하는, 억압적인; 숨이 막힐 듯한, 후텁지근한; (근심걱정으로) 답답한[질식할 것 같은]
sultry = 무더운, 후텁지근한; 관능적인, 섹시한
steep = (액체에) 적시다, 담그다(soak) ((in)); 함빡 젖게 하다; 깊이 배어들게 하다 ((with)); (물 등에) 잠기다 ((in)); 적심, 담금, 잠김
aura = (어떤 사람이나 장소에 서려 있는 독특한) 기운[분위기]
shimmer = 희미하게 빛나다, (빛을 받아) 어른[일렁]거리다; (일렁이는 듯한) 희미한 빛; 출발하다[(여행을) 시작하다]; (일과제 등에) 착수하다[나서다]
crackle = (타오르는 불이 내는 소리와 같이) 탁탁[치직] 소리를 내다; (짧고 날카롭게) 탁탁[따닥/치직]하는 소리
naughty = 버릇없는, 말을 안 듣는; 약간 무례한, 외설적인
mystify = 혼란스럽게[얼떨떨하게] 만들다
smeary = 더럽혀진; 얼룩투성이의; 끈적거리는, 눅진눅진한(sticky); 기름 밴(greasy)
crumb = (특히 빵케이크의) 부스러기; 작은 것; 약간, 소량
wriggle = (몸몸의 일부를) 꿈틀거리다[꼼지락거리다]; 꿈틀거리며 가다; 꿈틀거리기, 꼼지락거리기
colicky = 산통의; 산통을 일으키는; 산통으로 괴로워하는
yowl = (비통하게) 울부짖다
lash = 후려치다, 휘갈기다; (채찍밧줄막대기 등으로) 후려치다[갈기다]; (화가 나서 마구) 닦아[몰아]세우다
exuberant = 활기[생동감] 넘치는; 무성한, 잘 자라는
cock = <모자 챙을> 위로 젖히다; <모자를> 비뚜름하게 쓰다; <팔다리관절 따위를> 굽히다; <발 따위를> (책상 위에) 올리다 ((up, on))
confine = (활동주제지역 등을) 국한시키다; (사람동물 등을 좁은 장소나 폐쇄된 곳에) 넣다[가두다]; (질병 등으로 몸이) 침대, 휠체어 등에 얽매이다
edgy = 초조해하는, 불안한; 통렬한, 신랄한
spatter = (액체 방울 등을) 튀기다[튀겨서 뒤덮다]; 후두두 떨어지다; (액체 등이) 튀는[떨어지는] 것[방울들]; 후두두 떨어지는 소리
yonder = [한정사] 저기 있는[보이는]; 
tinge = (어떤 느낌기운 등을) 가미하다, ~한 기미[기색]를 더하다
tranquil = 고요한, 평온한
streaked = ~로 줄무늬가 생긴.
serenity = (하늘기후 등의) 고요함, 맑음, 화창함, 청명; (마음생활의) 평온, 평정, 침착; [S~] 전하 ((경칭))
ravish = 강간하다; 황홀하게 하다
whirl = 빙그르르[빙빙] 돌다[돌리다]; (마음생각 등이) 혼란스럽다[어지럽다]; 빙빙 돌기, 선회하기
dwelling = 주거(지), 주택; (특히 청하거나 초대하지 않는데도) (~를) 따라가다[따라붙다]
groggy = (질병심한 피로로) 몸을 가누지 못하는[정신이 혼미한]
solace = 위안, 위로; 위안[위로](이 되는 사람것); 
stray = (자기도 모르게) 제 위치[길]를 벗어나다; (생각논의 등이) 옆길로 새다[(딴 생각이야기로) 벗어나다]; 바람을 피우다
dubious = 의심하는, 미심쩍어 하는; 수상쩍은; 불확실한; 좋다고 할 수 없는
wander = (이리저리 천천히) 거닐다, 돌아다니다, 헤매다; (있어야 할 곳에서) 다른 데로 가다, (일행들로부터) 떨어져 나가다; 다른 데로 팔리다[흐르다], 산만해지다
pit = (크고 깊은) 구덩이; 갱, (광물) 채취장; 
boastful = 뽐내는, 자랑하는
courteous = 공손한, 정중한
crease = 주름이 생기게 하다[생기다], 구기다[구겨지다]; (피부에) 주름을 만들다[주름이 생기다]
companionable = 다정한
daunt = 겁먹게[기죽게] 하다
ponder = 숙고하다, 곰곰이 생각하다
crave = 갈망[열망]하다
perch = (특히 무엇의 끝에) 걸터앉다[앉히다]
soar = (가치물가 등이) 급증[급등]하다[치솟다]; (허공으로) 솟구치다; (하늘 높이) 날아오르다[날다]
indistinct = 또렷하지 않은, 흐릿한, 희미한
tiptoe = 발끝으로 살금살금 걷다
huddle = (보통 춥거나 무서워서) 옹송그리며 모이다; (보통 춥거나 무서워서) 옹송그리다; (특히 특별한 순서 없이) 옹기종기 모여 서 있는 것
inflection = (단어언어의) 굴절[어미어형 변화]; 억양, 어조
amend = (법 등을) 개정[수정]하다
pole = 막대기, 기둥, 장대(특히 한 쪽 끝을 땅에 박고 다른 것을 지탱하는 데 쓰는 나무금속으로 된 것); (지구의) 극; (자석의) 극
sniffle = (계속) 훌쩍거리다; 훌쩍거림; 훌쩍거리는 소리
foliage = 나뭇잎(한 나무의 나뭇잎이나, 나뭇잎과 줄기를 총칭)
enclosure = 울타리[담]를 친 장소; 울타리[담]를 두름; (편지에) 동봉된 것
rustle = 바스락거리다; 가축을 훔치다; 바스락거리는 소리
whimper = 훌쩍이다; 훌쩍이며 말하다; (사람이) 훌쩍거림; (동물이) 낑낑거림
knob = (텔레비전 등의 기계에 달린 동그란) 손잡이; (문서랍에 달린 동그란) 손잡이; (무엇의 표면이나 끝에 달린 동그란) 혹[마디/옹이]
peer = (특히 잘 안 보여서) 유심히 보다[눈여겨보다/응시하다]
on = 즉흥적으로, 충동적으로
solitary = (다른 사람 없이) 혼자 하는; 혼자 있기를 좋아하는, 혼자서 잘 지내는; 홀로 있는, 외딴
gruff = 걸걸한; 거친
grotesque = 터무니없는, 말도 안 되는(불쾌하거나 모욕적일 정도로 이상함을 나타냄); 기괴한[기이한](모습이 무섭거나 재미있게 이상함을 나타냄); (특히 책그림 속의) 괴물 같은 인물
fling = (특히 화가 나서 거칠게) 내던지다[내팽개치다]; (몸이나 신체 일부를 갑자기 힘껏) 던지다[내밀다]; (욕설 등을) 퍼붓다
slither = (매끄럽게) 스르르 나아가다[기어가다]; (비탈 등을 힘 안 들이고) 미끄러지듯 나아가다
gossip = (남의 사생활에 대한 좋지 않은) 소문, 험담; 수다, 한담; 남 얘기하기 좋아하는 사람, 험담꾼
scowl = 노려[쏘아]보다; 노려봄, 쏘아봄
detour = 둘러 가는 길, 우회로; ; 둘러 가다, 우회하다
glisten = 반짝이다, 번들거리다
relish = (어떤 것을 대단히) 즐기다[좋아하다]; (큰) 즐거움[기쁨]; 렐리시(과일, 채소에 양념을 해서 걸쭉하게 끓인 뒤 차게 식혀 고기, 치즈 등에 얹어 먹는 소스)
fitful = 잠깐씩 하다가 마는
riddance = 면함, 벗어남, 제거; 탈출 ((from)); 귀찮은 것[일]을 쫓아 버림
quizzical = 약간 놀란[재미있어하는] 듯한
afflict = 괴롭히다, 피해를 입히다
nurture = (잘 자라도록) 양육하다[보살피다]; 육성[양성]하다; (감정계획 등을 마음속으로) 키우다
scramble = (특히 힘겹게 손으로 몸을 지탱하며) 재빨리 움직이다
solemnly = 장엄하게; 진지하게
tangled = 헝클어진; 복잡한, 뒤얽힌
stuff = (빽빽히) 채워 넣다[채우다]
waif = (먹을 것이 없어서 영양실조에 걸린 듯) 비쩍 마른 사람[아동]
prop = 지주, 버팀목, 받침대; 지주(가 되는 사람것); (연극영화에 쓰이는) 소품
clamor = ; (군중 등의) 시끄러운 외침, 떠들썩함; (불평항의요구 등의) 부르짖음, 아우성, 소란(uproar) ((against, for))
filth = 오물, (아주 더러운) 쓰레기; (섹스와 관련된) 쓰레기 같은[아주 추잡한] 것(말잡지 등); <‘경찰’을 가리키는 비어>
clot = (혈액이나 크림이) 엉기다[응고되다]; (혈액이나 크림을) 엉기게 하다[응고시키다]
din = (오래 계속되는 크고 불쾌한) 소음
squalor = 불결한[누추한] 상태
roam = (이리저리) 돌아다니다, 배회[방랑]하다
stern = 엄격한, 단호한; 가혹한, 용서 없는
mordant = 신랄한, 통렬한
beam = 기둥
wistful = (지난 일을) 애석해[아쉬워]하는
lurk = (특히 나쁜 짓을 하려고 기다리며) 숨어 있다[도사리다]; (불쾌한 일위험이) 도사리다; (인터넷 채팅방에서 참여는 않고 대화 내용을) 읽기만[지켜보기만] 하다
exasperation = [U] 격분, 분노; 격화, 악화
thrash = (벌로서 매로) 때리다; 몸부림치다, 허우적거리다, 요동치다; 몸부림치게[허우적거리게/요동치게] 만들다; (경기에서) 완파하다
thrust = (거칠게) 밀다, 밀치다, 찌르다; (무기 등을 가지고 사람을) 찌르다; (주장정책 등의) 요지[취지]
appraise = 살피다, 뜯어보다; (업무를) 평가하다
pitcher = (귀 모양의 손잡이와 주둥이가 있는) 물주전자
tousle = (머리를) 헝클어뜨리다
spiteful = 앙심[독기]을 품은, 악의적인
punctuate = 간간이 끼어들다; (문장에) 구두점을 찍다
limb = (하나의) 팔[다리]; (새의) 날개; 팔다리가 ~한; (큰) 나뭇가지
gnarled = 울퉁불퉁하고 비틀린; 옹이가 많은; 쭈글쭈글한, 울퉁불퉁하고 비틀린
embitter = (오랜 시간 동안) 원통하게[쓰라리게] 만들다
gaunt = 수척한, 아주 여윈; 삭막한
sill = ; (차량 문 아래 부분의) 문틀
puddle = (특히 비 온 뒤의) 물웅덩이
stench = 악취
treacherous = 기만적인, 신뢰할 수 없는; (특히 겉보기와 달리) 위험한
clog = 막다; 막히다
chuck = (아무렇게나) 던지다
scamp = 개구쟁이, 장난꾸러기
expectant = (특히 좋거나 신나는 일을) 기대하는; 출산을 앞둔 엄마/곧 아이 아비가 될 사람/곧 부모가 될 사람
tread = (발을) 디디다, 밟다; 걸음걸이; 발소리
cling = 꼭 붙잡다, 매달리다; 달라[들러]붙다; 애착을 갖다
distress = 괴롭히다, 고통스럽게 하다
quiver = (가볍게) 떨다[떨리다]; (감정몸의 일부가) 떨림, 가벼운 전율; 화살(을 넣는) 통, 화살집
tragic = 비극적인; 비극의
boredom = 지루함, 따분함
interminable = (지겹고 짜증날 정도로) 끝없이 계속되는
recurrent = 되풀이되는, 반복되는, 재발되는
hum = 콧노래를 부르다, (노래를) 흥얼거리다; 웅웅[윙윙]거리다; 활기가 넘치다
lyrical = 서정적인, (표현이) 아름답고 열정적인
assuage = (안 좋은 감정을) 누그러뜨리다[달래다]
fragrance = 향기, 향; 향수
bickering = (특히 상습적이며 입이 건) 말다툼, 언쟁, 논쟁.
restring = (현악기운동 라켓의) 줄을 다시 매다[바꾸다]
palpable = 감지할 수 있는, 뚜렷한, 손에 만져질 듯한
chortle = (기쁘거나 재미있어서) 깔깔거리다
quest = 탐구, 탐색; 탐구[탐색]하다
impish = (심각하지 않을 정도로) 버릇없는[장난스러운]
fetid = 악취가 진동하는
sleet = 진눈깨비; 진눈깨비가 오다
engulf = 완전히 에워싸다, 휩싸다; (강한 감정 등이) 사로잡다
puzzle = 퍼즐, (머리를 써서) 알아맞히기; ; (이해설명하기 힘든) 수수께끼[미스터리]
drill = 반복 연습, 드릴; 반복 연습[훈련]시키다
loom = (특히 무섭게) 어렴풋이[흐릿하게] 보이다[나타나다]; (중요하거나 위협적인 일이) 곧 닥칠 것처럼 보이다; 베틀, 직기
doze = 깜빡 잠이 들다, 졸다; (보통 낮에) 잠깐 잠, 낮잠
nudge = (특히 팔꿈치로 살짝) 쿡 찌르다
aloft = 하늘[위로] 높이
clank = 철커덕하는 소리가 나다[소리를 내다]
muted = 조용한, (보통보다) 낮은; 부드럽게 완화시킨, 소리 죽인
collective = 집단의, 단체의; 공동의, 공통의; 공동 사업(체)
waggle = (상하좌우로) 흔들다[움직거리다]; 흔들리다, 움직이다
restrain = (특히 물리력을 동원하여) 저지[제지]하다; (감정 등을) 억누르다[참다]; (더 왕성해지지 못하도록) 억제하다
restless = (지루하거나 따분해서) 가만히 못 있는[들썩이는]; 제대로 쉬지[잠들지] 못하는
derisive = 조롱[조소]하는
cavernous = 휑뎅그렁한; 동굴 같은
beckon = (오라고) 손짓하다, (손짓으로) 부르다
shuffle = 발을 (질질) 끌며 걷다
straggle = (대오 등에서 뒤로) 처지다, 낙오되다
weary = (몹시) 지친, 피곤한; 지치게[피곤하게] 하는; ~에 싫증난
dread = (~을) 몹시 무서워하다; (안 좋은 일이 생길까 봐) 두려워하다; (안 좋은 일이 생길까 봐 갖는) 두려움; 두려운 것
upheaval = 격변, 대변동
usher = 안내하다
filthy = 아주 더러운
suffuse = (온통) 퍼지다[번지다]
pluck = (머리카락눈썹 등을) 뽑다; (요리하기 위해 닭 등의) 털을 뽑다; (기타 등의 현을) 뜯다[퉁기다]
cringe = (겁이 나서) 움츠리다[움찔하다]
grasshopper = 메뚜기
scoff = 비웃다, 조롱하다; (많은 양을 급히) 먹다[먹어 치우다]
celebratory = 기념[축하]하는
serene = 고요한, 평화로운, 조용한
intermission = (연극영화 등의) 중간 휴식 시간; (어떤 일이 계속되는 중간의) 중지[휴지]
stir = 젓다, (저어 가며) 섞다[넣다]; 약간 움직이다[흔들리다]; 약간 흔들다; (사람이 어떤 일을 하기 위해) 움직이다[꿈쩍하다]; 움직이게[꿈쩍하게] 하다
disruptive = 지장을 주는
murmur = 속삭이다, 소곤거리다, 중얼[웅얼]거리다; <조용하게 작은 소리를 계속 내다>; (드러내지 않고) 투덜거리다
forbidding = 험악한, 으스스한
frigid = 불감증의; 몹시 추운[찬]; 냉랭한
fruitful = 생산적인, 유익한; 수확[소출]이 많이 나는
seep = 스미다, 배다
fearsomeness = 무시무시함; 엄청남.
grievous = 통탄할[극심한](흔히 고통통증을 야기하는)
delirious = (보통 고열로 인해) 의식이 혼미한[헛소리를 하는]; 좋아서 어쩔 줄 모르는, 기뻐 날뛰는
fascinate = 마음을 사로잡다, 매혹[매료]하다
lilt = (듣기 좋은) 억양; (음악의) 리듬
daze = 멍하게 하다; 눈부시게 하다; 현혹시키다
club = 곤봉; (곤봉 같은 것으로) 때리다
envious = 부러워하는, 선망하는
weep = 울다, 눈물을 흘리다; 진물이 흐르다; 울기
wryly = 얼굴을 찌푸리고; 뒤틀려.
falter = 불안정해지다, 흔들리다; (자신이 없어 목소리가) 흔들리다[더듬거리다]; (자신감 부족으로 걸음이나 행동이) 흔들리다[머뭇거리다]; 나팔꽃
shade = 색조
squirt = (액체가스 등을 가늘게) 찍 짜다[내뿜다/뿌리다]; 찍 나오다[뿌려지다]
tug = (세게, 흔히 여러 번) 잡아당기다; (세게) 끌어당기다
wilt = (화초 등이[을]) 시들다[시들게 하다]; (사람이) 지치다[처지다/풀이 죽다]; you will (이때 you는 한 사람임); ~을 더 활기차게[생기가 돌게] 만들다
drawstring = (가방바지 등을) 졸라매는 끈
hem = (옷 등의) 단; 단을 만들다[올리다]
gleeful = 신이 난; 고소해 하는
slump = 털썩 앉다; 푹 쓰러지다
renegade = (과거 자신이 속했던 집단사회를 떠난) 이탈자; (특히 감정을 보일 거라고 예상되는 상황에서 아무런 감정 표현 없이) 사무적인
gimpy = 절름발이의
nestle = (아늑한 곳에) 자리잡다
harness = (말 등의 동물에[을]) 마구를 채우다[마구로 연결하다]; (동력원 등으로) 이용[활용]하다
stern = 엄중한, 근엄한
haunting = (아름답거나 슬프거나 무서워서) 잊을 수 없는[잊히지 않는]
trail = (길게연이어 나 있는) 자국[흔적]; (특히 사냥 때 뒤따라가는) 자취
scrape = (무엇을 떼어 내기 위해) 긁다, 긁어내다
rivulet = 시내, 개울
trickle = (액체가[를] 가늘게) 흐르다[흘리다/뿌리다]
scab = (상처의) 딱지
cake = (마르면서) 딱딱해지다
glimmer = (희미하게) 깜박이다[빛나다]
despair = 절망; 절망[체념]하다; (기습적으로) ~를 공격하다[~에게 달려들다]
gash = 깊은 상처[자상]; 깊이 베이다[찔리다]; 사라지다[없어지다/죽다]
lullaby = 자장가
astounding = 경악스러운, 믿기 어려운
